111111111111111
1000C10P0000001
100001000000001
100000100000001
100000111100001
100000000000001
100000111111111
100111000000001
100000000000E11
111111111111111