11111111111111111111111111111111111
1000C100011100011100000000000000001
10E00100011100011101101000000000001
10000000011100011101101000000000001
10000011100010100001101000000000001
1000C000011100011101101000000000001
10P00011111100111000001000000000001
10011100001001111000001000000000001
10000000C00001000001111000000000001
11111111111111111111111111111111111