1111111111111111111111111111111111111111111111111111
1111100C0011110000001111100P0011110000111100C0011111
1111100000111100000011111000001111000011110000011111
1111100000111100000011111000001111000011110000011111
1111111110000001111001110011100110011000000111001111
1111111110000001111001110011100110011000000111001111
1111111110000001111000000111100000011000000111001111
1111100000111100000011111000001111000011110000011111
1111100000111100000011111000001111000011110000011111
1111100000111100000011111000001111000011110000011111
1111111110000001111001110011100110011000000111001111
1111111110000001111001110011100110011000000111001111
1111111110000001111001110011100110011000000111001111
1111100000111100000011111000001111000011110000011111
1111100000111100000011111000001111000011110000011111
111110000011110000001111100E001111000011110000011111
1111111110000001111001110011100110011000000111001111
1111111110000001111001110011100110011000000111001111
1111111110000001111001110011100110011000000111001111
1111100000111100000011111000001111000011110000011111
111110C0001111000000111110000011110000111100C0011111
1111111111111111111111111111111111111111111111111111