1111111111111111111111111
1000C10001110E01110000001
1000010001110001110110001
1000000001110001110110001
1000001110001010000110001
1000C00001110001110110001
10P0000001110001110000001
1001110000100000100000001
10000000C0000000000000001
1111111111111111111111111